Derived from profession:
Kováč – Smith
Mlynár – Miller
Bača – shepherd
Rybár – fisher
Kráľ – king
Pekár – baker
Kuchár – cook
Mäsiar – butcher
Holič – barber
Maliar – painter
Kľúčiar – key maker
Mečiar – sword maker
Sklenár – glassmaker.
Derived from adjectives:
Čierny – black
Biely – white
Suchý – dry
Mokrý – wet
Slaný – salty
Smutný – sad
Šťastný – happy/lucky
Malý – small
Široký – wide
Tichý – quiet
Surový – raw
Others:
Koreň – root
Chren – horseradish
Repa – beet
Slanina – bacon
Polievka – soup
Cibuľka – little onion
Malina – raspberry
Dobrovodský – good water
Holub – pigeon
Chrobák – beetle
Komár – mosquito
Medvedík – little bear
Koleno – knee
Mráz – frost
Okienka – little window
Otčenáš – our father
Bezdeda – without a grandpa
Dolina – valley
Kocur – tomcat