Барбара (латинське) — язичниця, іноземка; поширене серед білорусів-католиків. Див. також: Варвара;
Будіслава (розм: Буде, Слава; старослов'янське) — буди / будити славу;
Броніслава (розм: Броня, Бронька, Слава; старослов'янське) — та, що оберігає славу;
Белла (розм: Белка; латинське) — вродлива
Валерія (розм: Лера, Валерка, Валюся, Люся, Люська; латинське) — здорова, міцна;
Валентина (розм: Валя, Валена, Валюша, Валюня, Тіна; латинське) — здорова, міцна;
Ванда — (розм: Вана, Вана, Вандзя, Вандочка; польське) — кокетка
Варвара (розм: Варя, Варця, Варка, Варус, Барбара, Барця, Барціся; латинське) — язичниця, іноземка.
Віра (роозм: Вірця, Вєрка, Віруня, Віруся; старослов'янське) — сподівання, надія;
Вероніка (розм: Віра, Ніка, Веронічка, Віка, Вічка; давньогрецьке) — та, що несе перемогу; за другою версією — уродженка італ. міста Верони ;
Вікторія (розм: розм. Віка, Вікуля, Вікта, Вікця, Викта; латинське) — перемога;
Віталіна (розм: Віталінка, Талліна, Талінка, Віта, Ліна; латинське) — життєва;
Віолетта (розм: Віта, Вітуля, Вітуся, Лєта, Вія, Тая; латинське) — фіалка;
Ольга (біл. Вольга) — (розм: Вольц, Волька, Вальжіна; древнескандинавского) — точної етимології немає, проте деякі вважають, що це жіночий варіант від імені Олег, що означає святий;
Венера (розм: Венерка, Нера, Віра; латинське) — красива, улюблена. Порівняння: [[Венера, богиня | Венера] — богиня любові і краси у древніх греків;
В'ячеслава (старослов'янське) — велика слава,
Анна (біл. Ганна) — (розм: Ганка, Анця, гінці, Гануся, Ганнуля; давньоєврейське) — симпатична, гарненька, розкіш, задоволення;
Галина (розм: Галя, Галька, Галинка, Галюня; давньогрецьке) — спокійна, добродушна, поступлива; за другою версією з латинської мови, де мало значення «курка»;
Домініка (розм: Домінічка, Даміся, Ніка; латинське) — «день Божий»;
Дорофія (розм: Дара, Фея, Дарфейка; давньогрецьке) — «дар Бога»;
Дарина (розм: Одарка, Адар, Дорота, Дарко; давньогрецьке) — переможець;
Єва (розм: Евця, Евка, Явціся; давньоєврейське) — жінка, жива, дружина Адама;
Євдокія — Авдіся, Авдотка, Авдося, Авдольця
Єфросинія (розм: Прося; давньогрецьке) — рідна;
Жанна (розм: Анця, Ануся, Анета; давньогрецьке) — Богом дана;
Юлія (розм: Юля, Юлька, Юльця, Юляся, Юліана; латинське або давньогрецьке) — з відомого римського роду Юлія або кучерява;
Ельвіра (розм: Еля, Елла, Ельвірка, Елюня, Елюся, Елюша, Віра; німецьке) — та, яка все захищає;
Еліна (розм: Еля, Елінка, Ліна давньогрецьке) — уродженка Греції, гречанка ;
Емма (розм: Емка, Еіуня, Муня; німецьке) — ретельна, копітка;
Емілія (розм: Миля, Аміль, Емма, Еля, Меля, Мільцеся; німецьке) — ласкава, запобіглива;
Чеслава (розм: Чеся, Слава; старослов'янське) — чекати слави;
Фекла — Текля



Уляна — Улянка, Уля
Ядвіга — Ядвіся, Ядя
Євгенія (біл. Яўгенія) — Югася, Геньця, Авгуся, Авгінья