Адам (розм: Адам; давньоєврейське) — людина;
Яким (біл. Акім) — (розм: Яким, Юктук, Юхим, Юхша; давньоєврейське) — розумний, освічений, мислячий, а також в значенні вчений, мислитель, мудрець;
Олег (біл. Алег) (розм: Алік, Льоша, Олежка; давньоскандинавське) — святий. Спочатку було князівським ім'ям;
Олександр (біл. Аляксандр) (розм: Олександр, Ольцік, Вольцік, Вольша, Алех, Алехно; давньогрецьке, дав.-гр. Αλέξανδρος дав.-гр. Αλέξανδρος — мужній, захисник;
Олексій (розм: Алёкса, Лекса і ін.; давньогрецьке) — захисник;
Анатолій (розм: Толя, Толік; давньогрецьке) — з області Стародавньої Греції — з Анатолії ;
Андрій (розм: Яндрей, Андрушах, Андрук; давньогрецьке) — мужній, відважний;
Аніс (розм: Анісік, Аниська, Аніс; давньогрецьке, дав.-гр. Ὀνήσιμος дав.-гр. Ὀνήσιμος) — корисний, доброчесний;
Антон (розм: Антоній, Антон; латинське або давньогрецьке) — «той, хто вступає в бій» або «хто купує взамін»;
Аркадій (розм: Аркадія, Арка; давньогрецьке) — з області Греції — з Аркадієм, з країни пастухів;
Арнольд (німецьке) — «потужний орел». Рідкісне ім'я, у селян майже не використовувалося;
Арсеній (розм: Арсеній, Арсен, Сеня, Арсік, Арсук, Арсім, Арсайла, Артіс, Арцім, Арціш; давньогрецьке) — мужній, відважний;
Артур (розм: Артус, Артук; кельтські) — мужній, відважний;
Артем (розм: Артюх; давньогрецьке) — здоровий, цілий;
Остап (біл. Астап) — (розм: Астапук, Астапка, Астахов, Асташов; давньогрецьке) — «який твердо стоїть», «твердий, незмінний, стійкий»;
Афанасій — (розм: Афанасій, Панас, Панась; давньогрецьке) — безсмертний;
жіночі
Агапія (розм: Агата, Гана; давньогрецьке) — хороша, добра;
Агрипіна (розм: Гріпіна, Агруся, Груня, Рипін; латинське) — етимологія невідома;
Аделаїда (розм: Аделя, Адька, Аделька, Адельця; німецьке) — гідна видом, шляхетна, шляхетного роду;
Акуліна (Килина) — (розм: Куліна, Акуліта; латинське) — орлина
Алла (давньогрецьке) — друга, наступна; за другою версією ім'я латинського походження;
Альона (розм: Лена, Олена, Ялена, Геля, Аліса; давньогрецьке) — світло, мерехтіння, блиск;
Олеся (біл. Алеся) — (давньогрецьке) — мужня;
Аліна (латинське) — інша, чужа;
Аліса (давньогрецьке) — правда;
Олександра (біл. Аляксандра) — (розм: Александріна; давньогрецьке ; дав.-гр. Ἀλεξάνδρα дав.-гр. Ἀλεξάνδρα) — мужня, захисник людей;
Анастасія (розм: Анастасія, Наська, Настя, Настуся, Настенька; давньогрецьке ; дав.-гр. Ἀναστασία дав.-гр. Ἀναστασία — «воскресіння») — «повернута до життя»;
Ангеліна (розм: ангел, Геля; давньогрецьке) — ангельське;
Анжеліка (розм: Ліка; латинське, лат. angelicus) — ангельська;
Анжела (розм: Елла; давньогрецьке) — «вісник», «посланник»;
Антоніна (розм: Антоля, Тоня; латинське або давньогрецьке) — квітка; та, хто вступає в бій;
Антонія (розм: Антона; латинське або давньогрецьке) — та, хто вступає в бій; хто купує взамін;
Анна, Анюта (давньоєврейське) — симпатична, гарненька, розкіш, задоволення;
Авдотья (розм: Аздоля, Авдюня, дюни, Авдютка, Дютка, Авдося, Дося; давньогрецьке) — благодать;


Богдан (розм: Богдан, Данчик, Бонік, Боня, Богус, Богуш; старослов'янське) — Богом даний;
Богуслав (розм: Багусь, Богцік, Багук, Богуш, Богша; старослов'янське) — той, хто славить Бога;
Базиль, Василь (давньогрецьке) — царський;
Болеслав (розм: Болес; старослов'янське) — славний, славніший за інших;
Боніфацій (розм: Боніфацій, Баніхват, Баніфацийка, Баня, Банюсь, Фаця, Ніхват, Боніфація, Боніс; латинське) — творець добра, благодійник;
Борис (розм: Боря, Борусь; давньогрецьке) — борець, борець; можливо, також від старослов'янського ;
Борислав (старослов'янське) — той, хто бореться за славу;
Будіслав (розм: Буде, Слава; старослов'янське) — буди / будити славу;
Броніслав (розм: Броня, Бранюк, Броняк, Слава; старослов'янське) — той, що оберігає славу;
Брячислав (розм: Брач, Слава; старослов'янське) — воїн;
Будимир (розм: буде, Діма, Мірик; старослов'янське) — той, що будить світ;
Вадим (розм: Вадик, Валік; старослов'янське) — звинувачувати, наговорювати;
Валерій (розм: Валер, Валерка; латинське) — сильний, здоровий, бадьорий;
Валентин (розм: Олесь, Валик; латинське) — здоровий, міцний;
Варфоломій (розм: Варфоломій, Бахрама, Бартош, Бавтрук, Будрис; давньоєврейське) — «син Толомея»;
Василь (розм: Василька, Вася, Васька, Базиль, Базилька; давньогрецьке) — царський;
Венедикт (розм: Бенедикт, Банада, Баніхват, Боніфація; латинське) — благословенний;
Вікентій (розм: Вінцук, Винця, Вінсент; латинське) — той, хто перемагає;
Віктор (розм: Вікцік, Віктук, Віктусь; латинське) — перемога;
Віталій (розм: Віталій, Віталія; латинське) — «життєвий». У білорусів поширене переважно в сім'ях міської інтелігенції;
Вітовт (розм: Вітус, Вітак; латинське) — «гнати народ»;
В'ячеслав (розм: Вячко, Вячик, Слава, Славка; старослов'янське) — «славлячи славу», «той, хто мріє прославитися»;
Горислав (старослов'янське) — "той, хто "горить «славою»;
Гаврило (розм: Гаврус, Гаврик, Гаврук, Гавра, Габрук, Габро; давньоєврейське) — божий чоловік;
Георгій (розм: Юрик, Ярик, Юрка, Юрій, Юрій, Юрила, Ярило, Юрага, Алігор, Жора; давньогрецьке) — землероб;
Герасим — (розм: Герась, Гарась, Гараська, Гараска, Гарасюк, Грасс, Гарасік; давньогрецьке) — шанований
Геннадій (розм: Генка, Генусь, Гена; давньогрецьке) — благородний;
Гліб (розм: Глебка, Глебік; німецьке) — нащадок Бога;

Давид (розм: Давид, Давідчік, Давидюк, Давидік, Додзьо, Додік, Давидько; давньоєврейське) — улюблений;
Домінік (розм: Домка, Домінічок — латинське) — «день Божий»;
Данило (розм: Даник, Данусь, Дольцік, Данила, Дануль, Данук, Дануйла; давньоєврейське) — «Бог — мій суддя»;
Дорофій (розм: Дорох, Дорош, Дорошко, Доропей, Дорофейчик, Дарук, Дарця; давньогрецьке) — «дар Бога»;
Дмитро (розм: Змітрок, Дмитра, Змітро, Дімка; давньогрецьке) — "той, що належить богині землеробства Деметрі ";
Денис (розм: Дениска; латинське) — натхненний;

Ждан (розм: Жданко, Даня, Даник; старослов'янське) — той, кого чекали;

Євдоким (біл. Еўдакім) — Авдось, Авдік, Авдук, Авдотья, Авдияш
Омелян (біл. Емяльян) — Амяльян, Омелько

Захарія (розм: Захарія, Захар'я; давньоєврейське) — «пам'ять божа»;
Єгор (біл. Ягор) — Єгорка
Яків — Якуб, Янцік, Яктук, Яктусь, Ян
Ян (розм: Янка, Янук, Ясь; давньоєврейське) — «Яхве (Бог) змилостивився», «Яхве (Бог) помилував»
Євгеній (біл. Яўгеній) — Євген, Авгук, Авгусь, Авгей, Авгіяш, Геньцік, Геніс, Генюш
Юхим (біл. Яфім) — Яхімка
Едуард (розм: Едвард, Адуард, Едісь, Едзьо, Едюк, Едька; латинське) — той, хто охороняє;

Юлій (розм: Юлісь; латинське або давньогрецьке) — з відомого римського роду Юлія або кучерявий;
Юрій (розм: Юра, Юрок, Юрка, Юрій, Юра, Юхно; давньогрецьке) — землероб (народний варіант від Георгій);
Юхим (біл. Яфім) — Яхімка
Єгор (біл. Ягор) — Єгорка
Яків — Якуб, Янцік, Яктук, Яктусь, Ян
Чеслав (розм: Чесь, Слава; старослов'янське) — чекати слави;
Тихон (біл. Ціхан) — Тишка, Тихін
Тимофій (біл. Цімафей) — Цімук, Тимко, Цімусь
Станіслав — Стась, Стасик, Стасюк, Станіш
Степан — Стьопка
Семен — Симеон, Симон, Сьомка, Сімаш
Сергій (розм: Сергій, Серж; латинське) — стражник, дуже шанований

Володимир (біл. Уладзімір) (розм: Володік, Володька, Валодусь, Владико, Володша, Ладик, Владик, Ладись, Ладамір, Ладша; старослов'янське) — той, хто володіє світом;
Владислав (біл. Уладзіслаў) — залагодити, Владук, Ладись, Владзь, Влад
Федір (розм: Тодор, Федір, Ходась, Хадаш, Тодік, Хвядук, Феодосій; давньогрецьке) — божий дар;
Філіп -Пилип, Пилипко, Хвіліп
Франциск — Франтішек, Пронцік, Франак