

Жіночі
Зінаїда (розм: Зіна; давньогрецьке) — уроджена Зевсом, божественна;
Зося (давньогрецьке) — мудра. Основне: Софія;
І
Чоловічі
Іван (розм: Ян, Ясь, Івась, Івашко, Ясюк, Яська, Якцік, Янук, Ваня, Януш; давньоєврейське) — «Яхве (Бог) змилостивився», «Яхве (Бог) помилував». Основне: Ян;
Ігор (розм: Ігорьок; древньоскандинавське) — Ingvio — ім'я скандинавського бога багатства і varr — охороняти
Гнат (біл. Ігнат) — Ігнась, Ігнатко

Йосип (біл. Іосіф) — Йосип, Юзик, Юзок, Єська, Юзуль

Ілля — Ільяш, Іллюк, Гальяш

Жіночі
Ірена — Реня

Ірина — Аріна, Аріша, Арішка

К
Чоловічі
Казимир — Казік, Казюк

Карл — Карусь, Карук, Корша

Кирило (розм: Кирил, Кирик, Кірук, Кір'ян, Чурило; давньогрецьке) — володар, той, хто править, керує;
Кіндрат — Кандрась, Кандраш

Костянтин — Костя, Костик, Кость, Косташ, Констант, Констайла

Кузьма — Кузик, Кузмісь

Жіночі
Кароліна — Каруся, Карута
Крістіна, Христина — Христя, Крисця, Кристуся, Кріста
Ксенія — Аксюта, Аксьона, Аксініца
Катерина — Кася, Катя

Л
Чоловічі
Лаврентій — Лаврук, Лаврик, Лаврусь, Лаврентій, Лавр
Леонід — Ленько, Льонька

Жіночі
Лариса ('розм: Лара, Лора, Ларуська; давньогрецьке) — чайка;
Лідія ('розм: Лідка, Лідуся, Ліда; давньогрецьке) — мабуть, від назви області Стародавньої Греції — Лідії, що в Малій Азії;
Єлизавета (розм: Лісавета, Ліза; давньоєврейське) — клятва Бога мого ; та, що шанує Бога;
Лілія (розм: Ліля, Лілюня, Лілюся, Лілюша, Лільок, Лілюльчик; латинське) — від назви квітки лілії;
Любава (розм: Люба, Любаша, Любавачка; старослов'янське) — давнє язичницьке ім'я, що означає «кохана»;
Любомира (розм: Люба, Міра; старослов'янське) — улюблена людьми, світом;
Любов (розм: Люба, Любіна; старослов'янське) — прихильність, відданість, інтерес;
Людмила (розм: Люда, Міла, Людка, Людуся, Люся, Міля, Мілоша, Мілка, Мілуся; старослов'янське) — мила, добра людям;
Люція (розм: Лія, Люца, Люцилія; латинське) — світла;
М
Чоловічі
Максим — Максимка, Максюта

Матвій — Матук, Мацісь, Матіс, Матияш

Мирон — Мірцік, Мірук, Мірась, Міраш

Михайло (розм: Михась, Міхалка, Міхайла; давньоєврейське, івр. מִיכָאֵל) — «Хто як Бог», або «Той, Хто як Бог»;
Микита (розм: Митька; давньогрецьке) — переможець;
Микола — Миколка, Коля, Ніколя

Жіночі
Магдалена — Магда, Магді, Магдзіся, Магда

Маргарита — Маргуся, Магарета, Магареся

Марія — Марія, Маруся, Марка, Маріанна, Марися, Марті, Марія, Марина — Мариня

Н
Чоловічі
Жіночі
Наталя — Наталка, Наталька, Натася, Наталія

Ніна — Нінка, Нінуся

П
Чоловічі
Павло — Павлик, Павлюк, Павка, Пашка
Петро — Петрусь, Петрик, Пятрук, Петраш
Прокофій — Прокоп, Прокопка, Прокша

Жіночі
Поліна — Палінка, Полька, Польця, Полюся

Р
Чоловічі
Родіон — Радісь, Радик, Радька, Радюк, Роман — Ромаш, Ромцік, Рамук, Ромась

Жіночі
Раїса — Рая, Раєчка, Раїска
Регіна — Рася, Раська, Раїн

Жіночі
Світлана (розм: Свєта, Святланка, Ланка; старослов'янське) — світла, ясна;
Софія — Зоська, Зося, Сонька, Соня

Тарас (розм: Тарасик, Тарасюк, Тарасок-голубок; давньогрецьке) — бунтівник або турбувати, хвилювати;


Трохим (розм: Трофим, Атрох; давньогрецьке) — годувальник;
Жіночі
Таїсія (розм: Таїса, Тая, Тася, Таюня, Таюта, Таєчка; давньогрецьке) — та, яка належить Ісіді ;
Тамара (розм: Тома, Тамарка, Тамуся; давньоєврейське) — фінікова пальма;
Тетяна (розм: Таня, Тацянка, Тацяна, Танюся, Татка, Тата, Туся, Таша; латинське або давньогрецьке) — організатор;
У (В)
Чоловічі
Харлам (розм: Харлан, Харламка, Харлан; давньогрецьке) — радість, захоплення; той, хто сяє
Християн, Крістіан (розм: Хрисцік, Хрисцюк, Ян; давньогрецьке) — християнин
Жіночі
Християна (розм: Христя, Хрися, Яна; давньогрецьке) — християнка











